11111111111
10000000111
10000000001
10000000001
10000000001
10000000001
10000000001
10000000001
10000000001
10000000001
11111111111
